ES - Spagna
PT - Portogallo
FR - Francia
IT-NO - Nord Italia
IT-CNO - Centro Nord
IT-CSO - Centro Sud
IT-SO - Sud Italia
IT-SAR - Sardegna
IT-SIC - Sicilia
CH - Svizzera
AT - Austria
SI - Slovenia
HR - Croazia
ME - Montenegro
GR - Grecia
BE - Belgio
NL - Paesi bassi
DE - Germania
GB - Gran Bretagna
IE - Irlanda
IS - Islanda
DK-DK1 - Danimarca (occidentale)
NO-NO4 - Norvegia nord
SE - Svezia
FI - Finlandia
RU-1 - Russia
PL - Polonia
EE - Estonia
LV - Lettonia
LT - Lituania
CZ - Repubblica Ceca
SK - Slovacchia
HU - Ungheria
RS - Serbia
BG - Bulgaria
RO - Romania
TR - Turchia
GE - Georgia






